алушта=alushta
феодосия=feodosiya
ялта=yalta
севастополь=sevastopol
симферополь=simferopol
абакан=abakan
анапа=anapa
ангарск=angarsk
архангельск=arhangelsk
астрахань=astrahan
барнаул=barnaul
белгород=belgorod
благовещенск=amurskaya_oblast_blagoveschensk
чебоксары=cheboksary
челябинск=chelyabinsk
череповец=cherepovets
черняховск=chernyahovsk
чита=chita
екатеринбург=ekaterinburg
геленджик=gelendzhik
иркутск=irkutsk
ижевск=izhevsk
кабардинка=kabardinka
калининград=kaliningrad
казань=kazan
кемерово=kemerovo
хабаровск=habarovsk
ханты-Мансийск=hanty-mansiysk
кисловодск=kislovodsk
комсомольск-на-Амуре=komsomolsk-na-amure
кострома=kostroma
краснодар=krasnodar
красноярск=krasnoyarsk
курган=kurgan
курск=kursk
липецк=lipetsk
магадан=magadan
магнитогорск=magnitogorsk
махачкала=mahachkala
минеральные-Воды=mineralnye_vody
москва=moskva
мурманск=murmansk
находка=nahodka
нальчик=nalchik
нижневартовск=nizhnevartovsk
нижний-Новгород=nizhniy_novgorod
ноябрьск=noyabrsk
норильск=norilsk
ростов-на-дону=rostov-na-donu
ханты-мансийск=hanty-mansiysk
майма=mayma
сант-питербург=sankt-peterburg
сант-петербург=sankt-peterburg
санкт-питербург=sankt-peterburg
санкт-петербург=sankt-peterburg
питер=sankt-peterburg
новосибирск=novosibirsk
новосиб=novosibirsk
сиб=novosibirsk
горный=gorno-altaysk
